###################################
#............######################
#...............................###
#...............................###
#...............................###
#............################...###
#############################...###
#############################...###
######..........................###
######..........................###
######..........................###
######...##########################
######...##########################
######...##########################
######.........................####
######.........................####
######.........................####
######...###################...####
######...####...........####...####
######...####...........####...####
######.........................####
######.........................####
######.........................####
###################################

